1111111111
1111111111
1111111111
1111111111
1119009111
1119009111
9999009999
0000000000
0000000000
0000000000